openFile=Fájl megnyitása
saveFile=Fájl mentése
emulator=Stella Emulátor
emulatorNotFound=Stella emulátor felderítése sikertelen! Akarja maga megtalálni?
openEmulator=Stella Emulátor Megnyitása
exe=Futtatható Állományok
*=Minden fájltípus
new=Új Projekt
open=Projekt Megnyitása
save=Aktuális Munkamenet Mentése
saveAll=Teljes Projekt Mentése
closeProject=Projekt Bezárása
copy=Szöveg Másolása
paste=Szöveg Beillesztése
undo=Mûvelet Visszavonása
redo=Mûvelet Végrehajtása
spriteEditor=Sprite Szerkesztõ
playfieldEditor=Playfield Szerkesztõ
projectPath=Project Mappa:
screenSizeError=Képernyõ-méter hiba!
screenSizeErrorMessage=Legalább 1024x768-as felbontás javallott! Ennek ellenére folytassuk?
openFolder=Mappaválasztás
projectName=Projekt Neve:
ok=OK
cancel=Mégsem
unsaved=Nem Mentett Projekt
unsavedText=A projekted nem mentett módosításokat tartalmaz! Mentsük?
projectNewError=Új Projekt Hiba
projectNewErrorText=Nem sikerült '#name#' projektet létrehozni!
errorSystemText=Rendszerüzenet:
projectOpenError=Projekt Megnyitás Hiba
projectOpenErrorText=A(z) '#name#' projekt megnyitása sikertelen!
openProjectIndex=Projekt Indexfájl Megnyitása
project2600=Project2600 Fájlok
projectSaveError=Kód Mentés Hiba
projectSaveError=Hiba keletkezett #bank# #name# kódjának mentésekor!
selectedBank=Kiválasztott Bank:
selectedSection=Kiválasztott szekció:
projectList=Project List:
lockButton=Zárolt Bankok
lockManager=Bankzár Menedzser
exit=Kilépés
memoryManager=Memóriamenedzser
változók=Variables:
selectVar=Változó Kiválasztása
insertVar=Változó Beszúrása
selectArray=Tömb Kiválasztása
insertArray=Tömb Beszúrása
arrays=Tömbök:
fastSwitching=Gyorsváltás:
manageVariable=Változókezelés:
varName=Változó Neve:
create=Create
modify=Modify
delete=Delete
varAddress=Változó Címe:
usedBits=Felhasznált Bitek:
manageArray=Tömbkezelés:
arrName=Tömb Neve:
varNameTooShort=A változóneveknek legalább 4 karakter hosszúnak kell lennie!
varNameNotValid=A változónevek mindig betûvel kezdõdnek, betûk, számok, a mínusz- és az alsóvonás jel szerepelhet bennük.
arrNameTooShort=A tömbneveknek legalább 4 karakter hosszúnak kell lennie!
arrNameNotValid=A tömbnevek mindig betûvel kezdõdnek, betûk, számok, a mínusz- és az alsóvonás jel szerepelhet bennük.
arrVariables=Eltárolt Változók:
arrAvailable=Kompatibilis Változók:
systemVar=Rendszerváltozó neve került megadásra.
alreadyVar=A megadott nevet egy változó már használja.
alreadyArr=A megadott nevet egy tömb már használja.
freeMemory=Elérhetõ Memória:
basicRam=Globálisan Elérhetõ Általános RAM
saraRam=Globálisan Elérhetõ SARA RAM
basicRamLocal=Bank Szinten Elérhetõ Általános RAM
saraRamLocal=Bank Szinten Elérhetõ SARA RAM
varLocated=Azonos nevû változó található egy másik bank-ban.
arrLocated=Azonos nevû tömb található egy másik bank-ban.
commandName=A megadott nevet egy parancs már használja.
codeEditor=Kódszerkesztõ
subs=Alrutinok:
insertSub=Alrutin Beillesztése
selectSub=Alrutin Kiválasztása
bankLinks=Bankhivatkozások:
insertBankLinks=Hivatkozás Beillesztése
lockNChase=#bank# zárolva #lockname# által.
deliminatorSetter=Sorelválasztó Beállítása:
applyChanges=Módosítások Mentése
replacer=Szövegcserélõ:
originalText=Eredeti Szöveg
newText=Új Szöveg
thisText=Jelen Szekció
thisBank=Teljes Bank
fullCode=Teljes Kód
colorPalette=Színpaletták
alsoComments=Kommentekben Is
screenItems=Képernyõelemek:
insertItem=Elem Beillesztése
preview=Elõnézet
colorPicker=Színválasztó:
kernelType=Kernel Típusa:
notEnoughMemory=Nem áll rendelkezésre elegendõ memória!
kernelChangeFail=A #kernel# kernelre átállás sikertelen! Beállítások helyreállítása megtörtént!
changeKernel=Kernel Váltás
currentKernel=Jelenlegi Kernel:
availableKernels=Elérhetõ Kernelek:
warning=Vigyázat!
kernelChangeWarning=Kernelt váltani elõrehaladott fejlesztés esetén kockázatos. Ennek tudatában folytatod?
preview=Elõnézet:
height=Magasság:
index=Index:
playfield=Playfield:
background=Background:
name=Name:
fileExists=Létezõ fájl
overWrite=A megadott fájl már létezik. Felülírod?
a26=Atari 2600 Forrásfájl
differentKernel=Eltérõ Kernel Figyelmeztetés
differentKernelMessage=A fájlt másik kernellel készítették. Ennek tudatában folytatod?
notSavedFile=Nem Mentett Fájl
notSavedFileMessage=A fájl módosításokat tartalmaz! Mented most?
unableToOpenFile=Meghiúsult Megnyitás
unableToOpenFileMessage=Fájl megnyitása sikertelen!
loadPicture=Kép Betöltése
multiple=Többféle Formátum
importImage=Kép Betöltése
thresholdSetter=Küszöbérték Beállító:
invert=Invertálás
preferRight=Jobboldal Preferálása
testWithEmulator=Emulátorral Tesztelés:
spriteEditor=Sprite Szerkesztõ
frameNum=Képkockák Száma:
testColor=Teszt Háttérszín:
testSpeed=Teszt Sebesség:
testWidth=Tesztszélesség:
horMove=Vízszintes Mozgás
verMove=Függõleges Mozgás
testPlayfield=Playfield és Háttér Teszteléshez:
blank=*Üres*
refreshList=Lista Újratöltése
kernelTester=Kernel Tesztelõ
foundOut=Úgy fest, nagyon szeretsz klikkelni.
kernelFile=Kernel Fájl:
enterBank2=Belépés:
overscanBank2=Overscan:
kernelData=Kernel Adatok:
screenTopData=Screen Top Adatok
asm=6502 Assembly Kód
tileSetMode=Csempés Mód
testAsP1=Teszt P1-ként
music=Zeneszerkesztõ
selectChannel=Csatornaválasztó:
drum=Dob
hat=Cintányér
snare=Pergõ
horn=Duda
buzz=Buzz
selectedScreen=Kiválasztott Képernyõ
insertScreen=Új Képernyõ Beszúrása 
deleteCurrentScreen=Jelenlegi Képernyõ Törlése
notEmpty=Nem Üres
notEmptyMessage=A képernyõ tartalmaz hangjegyeket. Mégis törlöd?
buzzer=Buzz Hatás (basszus)
vibratio=Vibráció Hatás (##)
beat=Ütemezõ:
fadeOut=Elhalkulás:
toneLen=Hanghossz:
corrector=Korrigáló:
artist=Elõadó:
title=Cím:
musicExists=Létezõ Zene
musicExistsMessage=Az általad választott zeneszám név már foglalt! Felülírod?
cover=Borító:
banksToLock=Lezárandó Bankok:
bankLockError=Bankzárás Hiba
bankLockErrorMessage=Nem található szabad lezárható bank.
textColors=Betû/Háttér Színek:
frameColor=Keretszín:
visualizerColors=Megjelenítõ Színei:
importMedia=Médium Importálása:
importFile=Fájl Importálása
mid=MIDI Fájl
sid=SID (C64) Fájl
vgm=Adlib Zene Fájl
vgz=Adlib Zene Fájl
mod=MOD (Amiga) Fájl
importError=Médium Importálási Hiba
importErrorMessage=Nem sikerült a kiválasztott médium importálása, lehetséges, hogy inkompatibilis vagy sérült fájl.
overflow=Túlcsordulás
overflowMessage=Adattúlcsordulás történt. Az elkészült ROM hibás.
cutPerc=Zenei alap levágása
maxChannels=Maximális csatornakonvertálás:
64pxPicture=64 Pixeles Nagykép Szerkesztõ
48pxPicture=64 Pixeles Nagykép Szerkesztõ
savePicture=Kép Mentése
invertPF=PF pixelek tükrözése
invertColors=PF/BG színek felcserélése
reduceBG=Háttér koncentrálása
oneColorBG=Lehetséges BG redukálás egy színre
generateMusicRom=Mentése a Zenei ROM mappába
askForSomething=Értékmegadás Szükséges
askForSeconds=Add meg a rögzítendõ hosszt másodpercben!
askForSubTune=Add meg az aldal számát!
cutNoneSeen=Nem látható hangok kivágása
calculating=Számlálás...
editPicture=Kép Szerkesztése
ignoreNotes=Hangjegyek kihagyása:
sprite=Sprite:
drums=Dob és Csatornaprioritás Állító
channelPrio=Csatornaprioritás Módosítása
drumSettings=Dobeszközök Módosítása
midiInstrument=MIDI Hangszer:
atariInstrument=TIA Hangszer:
reAlign=Adat-újrarendezés
sid2midi=Sid2Midi Kézi Konverzió
sid2midiText=Miután az eredeti SID konverzió rutin elhasalt és több, mint 90 másodpercet konvertálnál, kézile g kell az eredmény a 'temp/temp.mid'-be mentened, ezt követõen a konverzió folytatódik.
deleteAllAfter=Töröl Minden Továbbit
deleteAllMessage=Minden jelen képernyõt követõ adat törlésre kerül! Folytatod?
dro=DOSBox nyers OPL
imf=Id Zenei Formátum
wlf=Id Zenei Formátum
raw=RDOS nyers OPL
amDisable=AM moduláció kikapcsolása az Adlib VGM fájlban?
amModulation=AM Moduláció
vibratioSettings=Vibratio Beállítások
vibratioSettingsMessage=Ki szeretnéd kapcsolni egységesen a YM3812 vibrációt?
setMidiTempo=Kérlek, add meg a midi tempót! (alapértelmezett: 1.00)
soundPlayer=Hanglejátszó
openSound=WAV Megnyitása
recordSound=WAV rögzítése
generateSpeech=Beszéd Generálása
wav=Wav Hangfájl
openWav=Hangfájl Megnyitása
play=Lejátszás
recordTime=Felvételi Idõ (ms):
pitch=Magasság:
speed=Sebesség:
throat=Torok:
mouth=Száj:
speech=Hangpróba
record=Felvétel
waveError=Wave Megnyitása Sikertelen
waveErrorMessage=A hangfájl feldolgozása sikertelen. Próbáld elõször 8000 Hz / 8bit / mono formátumúvá konvertálni!
saveToFile=Memória Beállítások Mentése
saveToFileBank=Csak Aktív Bank Mentése
restoreFile=Memória Beállítások Visszaeállítása
archive=Projekt Archiválása
screenTopBottom=Screen Top/Bottom Elemek
bigSprite=Screen Top/Bottom Sprite Szerkesztõ
archivedDates=Archivált Dátumok:
restore=Állapot Visszaállítása
archieveCurrent=Jelen Állapot Archiválása
numberOfFiles=Fájlok Száma:
sizeOfFiles=Fájlok Mérete:
enter=Belépés
leave=Elhagyás
subroutines=Alrutinok
lineHeight=Sormagasság:
spriteType=Sprite Típusa:
simple=Egyszerû
double=Dupla
overlay=Átfedõ
heightIndex=Magasság Index:
xOffset=X Eltolás
yOffset=Y Eltolás
generateRandom=Véletlenszerû Generálás
generateText=Szöveggenerálás
width=Hosszúság
menuMaker=Menu Fejlesztõ
numItem=Elemek száma
segments=Szegmensek:
screenTop=Képernyõ Teteje
screenBottom=Képernyõ Alja
addNew=Új Hozzáadása
testScreen=Képernyõteszt
emptyBank=#bank# #level# szintje üres
top=Felsõ
bottom=Alsó
screenItem=Képernyõelem Hozzáadása
availableScreenElements=Elérhetõ Képernyõelemek
changeFrameColor=Képernyõ Keret Színmódosító
constant=Konstans
variable=Változó
mustBeVar=Konstansnak vagy teljes 8bit széles változónak kell lennie!
segmentName=A szegmensnevek betûvel kezdõdnek, betûket, számokat és alsóvonást tartalmazhatnak!
nameAlready=A címkenév a #bank# #section# szekciójában már használva van!
mustBeVar2=Konstansnak vagy változónak kell lennie!
Picture64px=64 Pixel Széles Kép
no64px=Nem található 64 pixeles kép!
displayedHeight=Megjelenített Magasság:
indicatorTyp=Indikátor Típusa
dataVar=Adatváltozó
color=Szín
gradient=Áttûnés
maxVal=Maximális Érték
gradient1=Világosból Sötét
gradient2=Sötétbõl Világos
gradient3=Középen Világos
gradient4=Középen Sötét
spriteName=Sprite Neve
spriteVar=Sprite Változó
mirrored=Tükrözött
text=Szöveg
justifyRight=Jobbra Igazított
dots=Pöttyök (nem Vonal)
font=Betûtípus
default=Alapértelmezett
digital=Digitális
custom=Egyéni
numOfDigits=Számjegyek Száma
slotMachine=Nyerõgép Mód
screenTester=Képernyõteszt - Változók
sameColor=Ikonnal megegyezõ szín
digitsOnly=Csak Számok
missingItems=Nem található kompatibilis #item# a projekt #folder# mappájában!
24hours=24 órás mód
divider=Frame Osztó
decrement=Csökkenõ
xPoz=X Pozíció
textColor=Betûszín
backColor=Hattérszín
menu=Menü
defaultColors=Alapértelmezett Színek
activeColor=Aktív Szín
inactiveColor=Inaktív Szín
availableMusic=Elérhetõ Zene/Hang
addedMusic=Hozzáadott Zene/Hang
jukeBoxError1=A JukeBox-nak legalább egy dalt/hangot tartalmaznia kell!
banksNeeded=Bank Igény
banksLocked=Foglalt Bankok
jukeBoxError2=#item# számára további #number# bank foglalandó!!
autoLock=Autofoglalás
soundDataVars=Hangadat Elérési Változók
incompleteItem=Befejezetlen Elem Található
incompleteItemError=#item# befejezetlen a #bank#-on és a fordítás összeomlana!
missingLock=Hiányzó Foglalás
missingLockError=#item# a #bank#-n további lefoglalt bankokat igényel! Különben a fordítás összeomlik!
spriteColor=Sprite Színe
gradientSprite=Sprite Áttûnés
gradientBack=Háttér Áttûnés
particles=Részecskék
initialize=Alaphelyzetbe Állít
zero=Nulla
GRP0=Player 0 Sprite
GRP1=Player 1 Sprite
ENAM0=Missile 0
ENAM1=Missile 1
ENABL=Ball
PF0=Playfield 0. rész
PF1=Playfield 1. rész
PF2=Playfield 2. rész
HMCLR=Horizontális Eltoltás
COLUPF=Playfield Színe
COLUBK=Háttérszín
COLUP0=Player 0 Színe
COLUP1=Player 1 Színe
speedConst=Sebesség Állandók
sunMoon=Nap és Hold Sprite
cloud=Felhõ Sprite
direction=Irány
numOfLines=Sorok Száma:
baseColor=Alapszín
rainbow=Szivárvány
oneColor=Egyszínû
colorVar=Színváltozó
horizontal=Vízszintes
vertical=Függõleges
alterLastFrameColor=Utolsó Képernyõelem Keretszínének Felülírása
container=Konténer
linesOfPattern=Mintasorok
verticalMir=Függõlegesen Tükrözött
moveBack=Hátrafele mozgás
curved=Hajlított
gaps=Rések
none=Üres
minimap=Mini Map Mókoló
importPlayfield=Playfield Betöltése
region=Regió
ballColor=Labda Színe
dimensions=Dimenziók
fillThru=Y tengelyen engedélyezett túlcsordulás
spritePF=Sprite / Playfield Színe
minimap=MiniMap
bcd=Binárisan Kódolt Decimális
delimiterInName=Elválasztó található a névben!
startWithBank=Változónév nem kezdõdhet 'Bank'-kal!
recommendations=Javaslatok
number=Sorszám
level=Szint
command=Parancs
param=Param
comment=Megjegyzés
updateRow=Sor Módosítása
build=Projekt Lefordítása
findWord=Szó Keresése
ignoreCase=Kis/Nagybetû egyezik
replace=Csere a Következõre
replaceAll=Összes Cseréje
replaceInLine=Csere soron Belül
reIndent=Újraformázás
convertASM=Fordítás Assembly-re
errorOnASMConvert=Hiba Assembly-re fordításkor
errorOnASMConvertText=Hiányzó #type# pár a #line# soron található parancsnál! A fordítás nem kezdhetõ el!
compilerErrorParam=Helytelen #VAL# #PARAM# található a #BANK# #SECTION# szekciójában a #LINENUM#. soron! 
compilerErrorConstant=A konstansok csak decimális, bináris ('%11111111') vagy hexa ('$FF') értéket vehetnek fel!
compilerErrorCommand=Érvénytelen parancs #VAL# a #BANK# #SECTION# #LINENUM#. során!
compilerErrorVariable=A változók globálisak vagy adott bankhoz tartozók, és szükséges esetben írhatónak kell lenniük!
compilerErrorNumber=A számok 0-255 közöttiek, decimális, bináris ('%11111111') vagy hexa ('$FF') formátumban!
compilerErrorString=A stringek egyszerû szövegek ". ' vagy ' jellel határolva.
compilerErrorSub=Az alrutinokat minden bank "subroutines" szekciója deklarálja.
compilerErrorArray=A tömbök globálisak vagy adott bankhoz tartozók, és szükséges esetben írhatónak kell lenniük!
noEndFound=A #COMMAND# parancs #END# paranccsal zárandó! 
compilerErrorRegister=A regiszterek a típustól függõen írhatóak, vagy olvashatóak!
compilerErrorData=Az adat mindig egy asm fájlnév az adott adattípushoz tartozó mappában!
noStartFound=A záróparancs #COMMAND# nem kötõdik semmihez!
noSelectForCase=A #COMMAND# parancs nem tartozik "Select" jellegû parancshoz!
noEndForCase=A #COMMAND# alatt nem található "End-Select" jellegû záróparancs!
noCaseForDefault=A #COMMAND# esetén legalább egy, "Case" jellegû parancs használata szükséges!
missingOpeningBracket=A paraméterek elõl hiányzik a nyitó zárójel!
missingClosingBracket=A paraméterek mögül hiányzik a záró zárójel!
commandDoesNotNeedBrackets=A parancs nem igényel paramétereket, vagy zárójeleket!
sectionNotAllowed=A parancs csak az alábbi szekciókban használható: #SECTIONS#!
levelNotAllowed=A parancs csak az alábbi szinten használható: #LEVEL#!
paramNotNeeded=Túl sok paraméter került a parancshoz!
iteralError=Az "item" változó helytelenül használt! A "Do-items" parancsok nem illeszthetõek egymásba!
compilerErrorStatementCalc=A számító állítások számokat, változókat, konstansokat, zárójeleket és matematikai jeleket tartalmazhatnak!
compilerErrorStatementComp=Az összehasonlító állítások számokat, változókat, konstansokat, zárójeleket, matematikai jeleket és EGY összehasonlító jelet tartalmazhatnak!
compilerErrorStatementStr=A string állítások számokat, változókat, konstansokat, karakterláncokat és a '+' jelet tartalmazhetják!
compilerErrorASM=Hiba található a lefordított #LINENUM#. soron!
compilerErrorASMOpCode=#OPCODE# nem valódi operációkód vagy az #OPERAND# nem társítható hozzá!
compilerErrorASMNumber=#OPERAND# nem valós szám! A számok 0-255 közöttiek, decimális, bináris ('%11111111') vagy hexa ('$FF') formátumban!
compilerErrorASMRegisterAddr=#OPERAND# nem valós regiszter/memória cím!
compilerErrorASMRIOTRead=#OPCODE# olvasható regisztert vár. Talán a #OPERAND# a RIOT csak írható regisztere?
compilerErrorASMRIOTWrite=#OPCODE# írható regisztert vár. Talán a #OPERAND# a RIOT csak olvasható regisztere?
compilerErrorASMRIOTBoth=#OPCODE# olyan regisztert vár, ami egyszerre írható és olvasható. #OPERAND# egyirányú.
compilerErrorASMsARAWrite=#OPCODE# egy írható SARA címet vár. #OPERAND# egy csak olvasható cím! ( > $F079)
compilerErrorASMsARARead=#OPCODE# egy olvasható SARA címet vár!. #OPERAND# csak írható cím! ( < $F080)
compilerErrorASMsARABoth=#OPCODE# egy írható és olvasgató címet vár! A SARA címekre ez nem jellemzõ!
compilerErrorASMCPURead=#OPCODE# olvasható regisztert vár. #OPERAND# csak írható!
compilerErrorASMCPUWrite=#OPCODE# írható regisztert vár! #OPERAND# csak olvasható!
compilerErrorASMCPUBoth=#OPCODE# olyan címet vár, ami egyszere írható és olvasható! A CPU regiszterek címei egyirányúak!
compilerErrorASMVariableWrite=#OPCODE# írható változót vár! #OPERAND# csak olvasható!
compilerErrorASMVariableBoth=#OPCODE# egyszerre írható és olvasható változót vár! #OPERAND# nem megfelelõ (talán SARA vagy rendszerváltozó?)!
compilerErrorASMConstantWrite=#OPCODE# írható elemet vár el. A #OPERAND# egy kondtans, amiket csak olvasni lehet!
compilerErrorASMConstantBoth=#OPCODE# egyszerre írható és olvasható elemet vár. #OPERAND# egy konstans, amit csak olvasni lehet!
compilerErrorASMAddressRead=#OPCODE# olvasható címet vár. #OPERAND# csak írható!
compilerErrorASMAddressWrite=#OPCODE# írható címet vár el. #OPERAND# csak olvasható!
compilerErrorASMRegisterRead=#OPCODE# olvasható regisztert vár. #OPERAND# csak írható!
compilerErrorASMRegisterWrite=#OPCODE# írható regisztert vár. #OPERAND# csak olvasható!
compilerErrorStatementComprass=#PARAM# kifejezésben az összehasonlító elem (#VAR#) nem a nulladik szinten van!
compilerErrorStatementError=Szintaktikai hiba található a #PARAM# kfeiejezésben!
compilerErrorStatementComplex=#PARAM# kifejezés túl összetettl
compilerErrorStatementTemps=Nincs elég ideiglenes változó a #PARAM# képlet kiszámításához / változó tárolásához!
compilerErrorSubroutine=#PARAM# subroutine nem található a #BANK#-ben!
compilerErrorVarNotFound=#PARAM# változó nem elérhetõ a #BANK#-n!
compilerErrorNoEnd=Nem található záróparancs a #VAL# parancshoz a #LINENUM#. soron!
compilerErrorNoCases=Nem található case a #VAL# parancshoz a #LINENUM#. soron!
compilerErrorMoreDefault=Több, mint egy default található a #VAL# parancshoz a #LINENUM#. soron!
compilerErrorCaseNotNumber=Ha #VAR# változó adja a Select alapját, ezért a #PARAM# helyett számokat, változókat és konstansokat kell használni!
compilerErrorMustBe1=Ha konstans vagy változó tartozik a Select-hez, az értékének 1-nek kell lennie (mint "True"). A #PARAM# értéke #VAR#!
compilerErrorComprassNotFound=nem található összehasonlító elem a #PARAM# képletben!
compilerErrorZeroDiv=Tilos nullával osztani!
infiniteLoop=A "do" típusú parancsoknál, ha nincs kilépési feltétel, szükséges legalább egy "exit", "return", "goto" vagy "leave", különben biztosan végtelen ciklus alakul ki!
mustBePowerOf2=A Do-Frames parancs elsõ paramétere 1, vagy kettõ valamely hatványa lehet!
mustBeSmaller=A Do-Frames parancs második paramétere az elsõnél kisebb vagy egyenlõ!
compilerErrorArrNotFound=#PARAM# tömb nem elérhetõ a #BANK# bankban!
compilerErrorASMDuplicateLabel=#OPERAND# egynél többször fordul elõ a szekcióban!
compilerErrorASMKernelLabel=#OPERAND# címkét már a kernel használja!
compilerErrorASMKernelLabelShort=#OPERAND# túl rövid címkének! Minimum 8 karakter hosszúnak kell lennie!
compilerErrorBankLocked=Bank #PARAM# foglalt, nem használható képernyõváltásra!
compilerErrorBankOutOfRange=A bank #PARAM# nem elfogadott! Képernyõváltáshoz a 2-8 intervallum használható!
compilerErrorBankMissingPairInSection=A '#VAR#' parancshoz legalább egy '#VAL#' parancsnak kell tartoznia #PARAM# szekció(k)ban!
aliasToCommand=Aliaszok Parancsnévvé alakítása
noSubRoutineForReturn=A #COMMAND# parancs nem tartozik "Subroutine" jellegû parancshoz!
noEndSubRoutineForReturn=A #COMMAND# alatt nem található "End-Subroutine" jellegû záróparancs!
compilerErrorASMByteInvalidParameter=A byte beékelésnek valós számnak kell lennie! #OPERAND# érvénytelennek tûnik!
compilerErrorBCDOverFlow=99-nél nagyobb szám (#VAR#), mint BCD konstans!
compilerErrorNotValidNumber=Az objektumfüggvény paraméterként érvényelen számot (#PARAM#Ö kapott!! Csak a 0-255 közötti, decimális, bináris vagy hexadecimális számok elfogadhatóak!
compilerErrorConstValNotValidNumber=Az objektumfüggvénynek paraméterként átadott #PARAM# konstans értéke (#VAL#) érvénytelen! Csak a 0-255 közötti, decimális, bináris vagy hexadecimális számok elfogadhatóak!
constant=Projekt Konstansok
constantName=KOnstans
constantValue=Érték
constantValidityType=Érvéyesség Típusa
constantValidityBank=Érvényes Bankok
constantValiditySection=Érvényes Szekciók
global=Globális
bank=Bank
section=Szekció
repeatingIsOnTop=Ismétlõdõ Felül (= P0)
repeatingPattern=Ismétlõdõ Minta
addBorders=Keretezés
initMode=Inicializálás
autoDetect=Automatikus Beállítás
repeatingIsOnTop2=Ismétlõdõ\nFelül
oneColor2=Egyszínû Háttér
eTolerance=Hibatûrés
segmentMethod=Egységesítési Mód
forceBlack=Fekete Mindig Háttér
setBorder=Keretezõ PF
48pxCanvas=48Px Képszerkesztõ
openCanvas=Képszerkesztõ Megnyitása
drawLayer=Rajzolandó Réteg
playfieldLayer=Playfield Réteg
uniqueLayer=Egyedi Réteg
repeatingLayer=Ismétlõdõ Réteg
shiftImage=Képeltolás
frameNotSaved=Nem Mentett Kép
frameNotSavedMessage=A jelenlegi képen nem mentett adatok vannak! Mentsem?
pickedColor=Kiválasztott Szín